1111111111111111111111
100001C1000001000000E1
1000010100001P10000001
1000000000000100000001
100C000000000000000001
1111111111111111111111
