1111111111111111111111
1P10C010C010C010C01011
1010101010101010101011
1010101010101010101011
10C010C010C010C010C0E1
1111111111111111111111
